{
    "ValidLevels" : {
        "1": {
            "ValidGridRefs" : {
                "B2" :  {},
                "B3":   {},
                "B4":   {},
                "B5":   {},
                "B6":   {},
                "B7":   {},
                "C2":   {},
                "C3":   {},
                "C4":   {},
                "C5":   {},
                "C6":   {},
                "C7":   {"name": "Castle entrance", "exits": {"South": "D7"}},
                "D2":   {},
                "D3":   {},
                "D4":   {},
                "D5":   {},
                "D6":   {},
                "D7":   {"name": "Central graveyard", "exits": {"North": "C7"}},
                "E2":   {},
                "E3":   {},
                "E4":   {},
                "E5":   {},
                "E6":   {},
                "E7":   {},
                "F2":   {},
                "F3":   {},
                "F4":   {},
                "F5":   {},
                "F6":   {},
                "F7":   {}
            }
        },
        "2": {
            "ValidGridRefs" : {               
                "B2" :  {},
                "B3":   {},
                "B4":   {},
                "B5":   {},
                "B6":   {},
                "B7":   {},
                "C2":   {},
                "C3":   {},
                "C4":   {},
                "C5":   {},
                "C6":   {},
                "C7":   {},
                "D2":   {},
                "D3":   {},
                "D4":   {},
                "D5":   {},
                "D6":   {},
                "D7":   {},
                "E2":   {},
                "E3":   {},
                "E4":   {},
                "E5":   {},
                "E6":   {},
                "E7":   {},
                "F2":   {},
                "F3":   {},
                "F4":   {},
                "F5":   {},
                "F6":   {},
                "F7":   {}
            }
        },
        "3": {
            "ValidGridRefs" : {                     
                "B2" :  {},
                "B3":   {},
                "B4":   {},
                "B5":   {},
                "B6":   {},
                "B7":   {},
                "C2":   {},
                "C3":   {},
                "C4":   {},
                "C5":   {},
                "C6":   {},
                "C7":   {},
                "D2":   {},
                "D3":   {},
                "D4":   {},
                "D5":   {},
                "D6":   {},
                "D7":   {},
                "E2":   {},
                "E3":   {},
                "E4":   {},
                "E5":   {},
                "E6":   {},
                "E7":   {},
                "F2":   {},
                "F3":   {},
                "F4":   {},
                "F5":   {},
                "F6":   {},
                "F7":   {}
            }
        },
        "4": {
            "ValidGridRefs" : {               
                "B2" :  {},
                "B3":   {},
                "B4":   {},
                "B5":   {},
                "B6":   {},
                "B7":   {},
                "C2":   {},
                "C3":   {},
                "C4":   {},
                "C5":   {},
                "C6":   {},
                "C7":   {},
                "D2":   {},
                "D3":   {},
                "D4":   {},
                "D5":   {},
                "D6":   {},
                "D7":   {},
                "E2":   {},
                "E3":   {},
                "E4":   {},
                "E5":   {},
                "E6":   {},
                "E7":   {},
                "F2":   {},
                "F3":   {},
                "F4":   {},
                "F5":   {},
                "F6":   {},
                "F7":   {}
            }
        }
    }
}